1011101001
1110101001
0000101111
1111101001
1000001001
1011111111
1010000001
1111111101
0000010101
1111110111