1111110111
1001010101
1000000101
1110111101
1010100001
1010111100
0010000111
1010111110
1010101010
1111101011