0111010111
0101010101
0101010001
0001011111
1111010010
1000010010
1111111110
1000001000
1011111111
1110000001